111111111111111111111111111111111111111111111111111111111111111
1.............................................................1
1.............................................................1
1.............................................................1
1............11111............................................1
1...111111..........1111......................................1
1P...........1111..................e..........................1
111111111111111111111111111111111111111111111111111111111111111
